1111111111
1000000001
1000000001
1A0AC000E1
1P0A000001
100AC00001
1000000001
100C000001
1000000001
1111111111
