111111111111111111111111111111111111111111111111111111111111111
1P00000000000000000C000000A000000C00000000000C000000000000000E1
111111111111111111111111100011111111111111111111111111111111111
111111111111111111111111111111111111111111111111111111111111111
