1111111111111111111111111111111111
1E000000000000AC00000C000000000CA1
10100101001000001010010000AA010101
10100100101010100010010000AA010101
1P0000000C00C000000000000000000CA1
1111111111111111111111111111111111
